#######################################
#.....................................#
######################.################ 
######################.################
#######################################
\robot 1 3
\robot 2 3
\robot 3 3
